NO ./img/NO1.png
SO ./img/SO1.png
WE ./img/WE1.png
EA ./img/EA1.png
F 10,20,50
C 8,30,50


  11111111111
  10T000L0001
  10000000011
111D11110011111111
1L0001  100T0000001
1000T11110001000001
11D1110E0000T00111
1000000001101111
 1000T0011101
 11111111 111
