NO ./img/NO1000.png
SO ./img/SO1000.png
WE ./img/riesig1000.png
EA ./img/EA1000.png
DOOR ./img/algen.png
TARGET ./img/fish500.png
BUBBLES ./img/bubbles.png
SAND ./img/stones.png
F 55,130,250
C 80,230,250



1111111111
1000000001
10000000011
111D1100001
10000000T01
1000T000011
11D1000E001
10000000011
1000T000001
11111111111
