NO ./img/wall_test.png
SO ./img/wall_test.png
WE ./img/wall_test.png
EA ./img/wall_test.png
DOOR ./img/algen.png
TARGET ./img/fish500.png
AIR ./img/Scuba_tank.png
F 55,130,250
C 80,230,250



11111111111
10L01000001
1LTL1000001
10L010000011
100010000011
10E0D0000101
100010000001
111110000001
10000000011
1000000001
10000000011
10001110001
11111 11111
