NO ./img/NO1000.png
SO ./img/SO1000.png
WE ./img/riesig1000.png
EA ./img/EA1000.png
C 80,230,250
F 55,130,250



1111111111111
1100000010001
1101010010001
1100000000001
1100000010001
1101010010001
1111011110N0111
 101111010001
 111111111111
