NO ./img/N.png
SO ./img/SO.png
WE ./img/WE.png
EA ./img/EA.png
F 55,130,250
C 80,230,250



1111111111
1000000001
10N0000001
1000000001
1000000001
1000000001
1000000001
1000000001
1000000001
1111111111
