NO ./img/NO10001.png
SO ./img/SO10001.png
WE ./img/riesig1000.png
EA ./img/EA10001.png
DOOR ./img/algen.png
TARGET ./img/fish500.png
F 55,130,250
C 80,230,250



1111111111
1000000001
10000000011
111D1100001
10000000001
10000000011
11110000001
1000000S011
1000T000001
11111111111
