NO ./img/NO10001.png
SO ./img/SO10001.png
WE ./img/riesig1000.png
EA ./img/EA10001.png
F 55,130,250
C 80,230,250



1111111111
1000000001
1000000001
1000000001
1000W00001
1000000001
1000000001
1000000001
1000000001
1111111111
