NO ./img/riesig1000.png
SO ./img/riesig1000.png
WE ./img/riesig1000.png
EA ./img/riesig1000.png
F 55,130,250
C 80,230,250



1111111111
1000000001
10E0000001
1000000001
1000000001
1000000001
1000000001
1000000001
1000000001
1111111111
