NO ./img/wall_test.png
SO ./img/wall_test.png
WE ./img/wall_test.png
EA ./img/wall_test.png
DOOR ./img/algen.png
TARGET ./img/fish500.png
AIR ./img/Scuba_tank.png
F 55,130,250
C 80,230,250



	1111111111111111111111111
		100000000011000111111111111
111111111110000000000001
100100000000000000000001111111111
111111111011000001110000000000001
100000000011000001110111111111111
11110111111111011100000010001
11110111111111011101010010001
11000000110101011100000010001
1000E000000000001100000010001
10000000000000001101010010001
11000001110101011111011110N0111
11110111 1110101 101111010001
11111111 1111111 111111111111