NO ./img/NO10001.png
SO ./img/SO10001.png
WE ./img/riesig1000.png
EA ./img/EA10001.png
DOOR ./img/algen.png
TARGET ./img/fish500.png
F 55,130,250
C 80,230,250



11111111111
10001000001
10T01000001
100010000011
100010000011
10N0D0000001
100010000001
111110000001
10000000011
1000000001
10000000011
10000000001
11111111111
