NO ./img/wall_test.png
SO ./img/wall_test.png
WE ./img/wall_test.png
EA ./img/wall_test.png
DOOR ./img/algen.png
TARGET ./img/fish500.png
F 55,130,250
C 80,230,250



11111111111
10001000001
10T01000001
100010010011
100010000011
10W0D0000101
100010000001
111110000001
10000000011
1000000001
10000000011
10001110001
11111 11111
