NO ./img/NO10001.png
SO ./img/SO10001.png
WE ./img/riesig1000.png
EA ./img/EA10001.png
DOOR ./img/algen.png
TARGET ./img/fish500.png
BUBBLES ./img/bubb800.png
AIR ./img/Scuba_tank.png
F 55,130,250
C 80,230,250



1111111111
10T00000001
10000000011
111D1100001
10000000T01
1000T000011
11D1000E0L1
10000000011
1000T011101
1111111 111
