NO ./img/NO1000.png
SO ./img/SO1000.png
WE ./img/riesig1000.png
EA ./img/EA1000.png
F 55,130,250
C 80,230,250



11111111111
10T000L000 
10000000011
111D1100001
10000000T01
1000T000011
11D1000E0L1
10000000011
100T0011101
1111111 111
